tileset
30 15 
000000000000000000000000000000
000222222220002222222222222000
002000200010000000000100000000
000000200111010000001111000000
000000200011111002000111000000
000000200100010002001100000000
000000200110000002000000000000
000110001000000221122222222200
000010011000000011100000000000
001100110002000011110000000000
001100110002000110110110100000
001100000002001001100011100000
000000000002000001000011000000
000000000002000000000000000000
000000000002000000000000000000
